1111111
1P000E1
1011101
1C010C1
1011101
1C000C1
1111111