11111111111
1P0001000E1
11101010111
1C0010000C1
10111011101
1C000C000C1
11111111111