1111111111111111111111111111111111
1000000000000000000000000000000001
1000000000000000000000000000000001
100000000000000000C000000000000001
1000000000000000000000000000000001
1000000000000000000000000000000001
1000000000000000000000000000000001
10000000000000000000C00000000000P1
10000000000000000000000000000000E1
1111111111111111111111111111111111