1111111111111
1E0000C0000C1
1010010000101
1P000C0000001
1111111111111